pppppppppppppppppppp
po.................p
p..................p
p..................p
pxx.p.xxx.p.xxx.p.xp
pxx.p.xxx.p.xxx.p.xp
pxx.p.xxx.p.xxx.p.xp
pxx.p.xxx.p.xxx.p.xp
pxx.p.xxx.p.xxx.p.xp
pxx...............xp
pxx...............xp
pxx.....xxxxx.....xp
pxx...............xp
pxx...............xp
pppppppppppppppppppp
