o...................
x.x...x...x...x...x.
x...x...x...x...x...
x.x...x...x...x...x.
x...x...x...x...x...
x.x...x...x...x...x.
x...x...x...x...x...
x.x...x...x...x...x.
x...x...x...x...x...
x.x...x...x...x...x.
x...x...x...x...x...
x.x...x...x...x...x.
x...x...x...x...x...
x.x...x...x...x...x.
xxxxxxxxxxxxxxxxxxxx
