o...................
....................
www..............www
www..............www
www..............www
....................
....................
....................
wwwwwwwww.wwwwwwwwww
....................
....................
....................
....................
pppppppppppppppppppp
kkkkkkkkkkkkkkkkkkkk
