o........p..........
.........p..........
.........p..........
.........p..........
.........p..........
.........p..........
.pppppppppppppppppp.
.........p..........
.........p..........
.........p..........
.........p..........
.........p..........
.........p..........
.........p..........
....................

